Dispute                  |                     dispute;
DisputeStatus                  |                     disputestatus;
DisputeType                  |                     disputetype;
AccountTransaction                  |                     accounttransaction;
AccountTransactionStatus                  |                     accounttransactionstatus;
AccountTransactionType                  |                     accounttransactiontype;
ContentOrderFile                  |                     contentorderfile;
ContentOrder                  |                     contentorder;
PaymentStatus                  |                     paymentstatus;
ContentOrderStatus                  |                     contentorderstatus;
ContentOrderType                  |                     contentordertype;
ContentClassification                  |                     contentclassification;
ContentFile                  |                     contentfile;
Content                  |                     content;
ContentType                  |                     contenttype;
ContentCategory                  |                     contentcategory;
Classification                  |                     classification;
ClassificationType                  |                     classificationtype;
PartyReview                  |                     partyreview;
PartySubject                  |                     partysubject;
PartyEducation                  |                     partyeducation;
WritingStyle                  |                     writingstyle;
Subject                  |                     subject;
SubjectAreaImage                  |                     subjectareaimage;
SubjectArea                  |                     subjectarea;
Urgency                  |                     urgency;
NoOfPages                  |                     noofpages;
DocumentType                  |                     documenttype;
AcademicLevel                  |                     academiclevel;
QualificationType                  |                     qualificationtype;
ContactRequest                  |                     contactrequest;
SocialMediaAccount                  |                     socialmediaaccount;
SocialMediaAccountType                  |                     socialmediaaccounttype;
PartyFile                  |                     partyfile;
PartyImage                  |                     partyimage;
BillingAccount                  |                     billingaccount;
PartyProfile                  |                     partyprofile;
Person                  |                     person;
PartyGroup                  |                     partygroup;
PartyRole                  |                     partyrole;
Party                  |                     party;
RoleType                  |                     roletype;
PartyType                  |                     partytype;
PartyCategory                  |                     partycategory;
Business                  |                     business;
Country                  |                     country;
Currency                  |                     currency;
